#################################################################################################################################
#################################################################################################################################
#################################################################################################################################
#################################################################################################################################
#################################################################################################################################
#####                                                         #####                                                         #####
#####                                                         #####                                                         #####
#####                                                         #####                                                         #####
#####                                                         #####                                                         #####
#####                                                         #####                                                         #####
#####                                                         #####                                                         #####
#####                                                         #####                                                         #####
#####                                                         #####                                                         #####
#####                                                         #####                                                         #####
#####                                                         #####                                                         #####
#####                                                         #####                                                         #####
#####                                                         #####                                                         #####
#####                                                         #####                                                         #####
#####                                                         #####                                                         #####
#####                                                         #####                                                         #####
#####                                                         #####                                                         #####
#####                                                         #####                                                         #####
#####                                                         #####                                                         #####
#####                *                             *          #####          *                             *                #####
#####                                                         #####                                                         #####
#####                                                         #####                                                         #####
#####                   #########################             #####             #########################                   #####
#####                   #########################             #####             #########################                   #####
#####                   #########################             #####             #########################                   #####
#####                   #########################             #####             #########################                   #####
#####                   #########################             #####             #########################                   #####
#####                                                         #####                                                         #####
#####                                                         #####                                                         #####
#####                *                             *                         *                             *                #####
#####                                                                                                                       #####
#####                                                      *         *                                                      #####
#####                                                                                                                       #####
#####                                                                                                                       #####
#####                                                                                                                       #####
#####                                                                                                                       #####
#####                                                                                                                       #####
#####                      *         *                                                     *         *                      #####
#####                                                                                                                       #####
#####                                            *                             *                                            #####
#####                         #####                                                           #####                         #####
#####                         #####                                                           #####                         #####
#####                         #####                 #########################                 #####                         #####
#####                         #####                 #########################                 #####                         #####
#####                         #####                 #########################                 #####                         #####
#####                         #####                 #########################                 #####                         #####
#####                         #####                 #########################                 #####                         #####
#####                         #####                                                           #####                         #####
#####                         #####                                                           #####                         #####
#####                         #####              *                             *              #####                         #####
#####                         #####                                                           #####                         #####
#####                         #####                                                           #####                         #####
#####                         #####                                                           #####                         #####
#####                         #####                                                           #####                         #####
#####                         #####                                                           #####                         #####
#####              *          #####                                                           #####          *              #####
#####                         #####                                                           #####                         #####
#####                         #####                                                           #####                         #####
#################             #####                                                           #####             #################
#################             #####                                                           #####             #################
#################             #####                                                           #####             #################
#################             #####                                                           #####             #################
#################             #####                                                           #####             #################
#####                         #####                                                           #####                         #####
#####                         #####                                                           #####                         #####
#####              *          #####                                                           #####          *              #####
#####                         #####                                                           #####                         #####
#####                         #####                                                           #####                         #####
#####                         #####                                                           #####                         #####
#####                         #####                                                           #####                         #####
#####                         #####                                                           #####                         #####
#####                         #####              *                             *              #####                         #####
#####                         #####                                                           #####                         #####
#####                         #####                                                           #####                         #####
#####                         #####                 #########################                 #####                         #####
#####                         #####                 #########################                 #####                         #####
#####                         #####                 #########################                 #####                         #####
#####                         #####                 #########################                 #####                         #####
#####                         #####                 #########################                 #####                         #####
#####                         #####                                                           #####                         #####
#####                         #####                                                           #####                         #####
#####                                            *                             *                                            #####
#####                                                                                                                       #####
#####                      *         *                                                     *         *                      #####
#####                                                                                                                       #####
#####                                                                                                                       #####
#####                                                                                                                       #####
#####                                                                                                                       #####
#####                                                                                                                       #####
#####                                                      *         *                                                      #####
#####                                                                                                                       #####
#####                *                             *                         *                             *                #####
#####                                                         #####                                                         #####
#####                                                         #####                                                         #####
#####                   #########################             #####             #########################                   #####
#####                   #########################             #####             #########################                   #####
#####                   #########################             #####             #########################                   #####
#####                   #########################             #####             #########################                   #####
#####                   #########################             #####             #########################                   #####
#####                                                         #####                                                         #####
#####                                                         #####                                                         #####
#####                *                             *          #####          *                             *                #####
#####                                                         #####                                                         #####
#####                                                         #####                                                         #####
#####                                                         #####                                                         #####
#####                                                         #####                                                         #####
#####                                                         #####                                                         #####
#####                                                         #####                                                         #####
#####                                                         #####                                                         #####
#####                                                         #####                                                         #####
#####                                                         #####                                                         #####
#####                                                         #####                                                         #####
#####                                                         #####                                                         #####
#####                                                         #####                                                         #####
#####                                                         #####                                                         #####
#####                                                         #####                                                         #####
#####                                                         #####                                                         #####
#####                                                         #####                                                         #####
#####                                                         #####                                                         #####
#####                                                         #####                                                         #####
#################################################################################################################################
#################################################################################################################################
#################################################################################################################################
#################################################################################################################################
#################################################################################################################################